................
.##############.
.#.1.#.....#..#.
.#.1.#..#..#2.#.
.#.11#.....#..#.
.#...#..#.....#.
.#......#.....#.
.###.#..#1.#..#.
.#...#.....#..#.
.#......#.....#.
.#..2...#..#..#.
.#..2#..#.3#..#.
.#...#..#33.3.#.
.#...#.....#..#.
.##############.
................
1 2 3
33
33
