................
...11......11...
................
...##########...
...#........#...
...#........#...
..##........#...
.......11...##..
..##...11.......
...#........##..
...#........#...
...#........#...
...##########...
................
...11......11...
................
1
1111
1111
