................
.##############.
.#............#.
.#............#.
.#..2222......#.
.#..21122.....#.
.#..22122.....#.
.#.2..12......#.
.#.....2222...#.
.#............#.
.#............#.
.#............#.
.#............#.
.#............#.
.##############.
................
1 2
