................
................
...##########...
.###........#...
.#..........##..
.#...#..#....#..
.#......4.#..#..
.#..#44#4....#..
.#....###....#..
.#....4#44#..#..
.#..#.4......#..
.#....#..#...#..
.##..........#..
..#........###..
..##########....
................
4
444
4.4
444
